00000000000000xxxxxxxxxx0000000000
0000000000000x0000000000x000000000
000000000000x000000000000x00000000
00000000000x00000000000000x0000000
0000000000x0000000000000000x000000
0000000000x0000000000000000x000000
0000000000x0000000xx0000000x000000
0000000000x0000000xx0000000x000000
0000000000x0000000000000000x000000
0000000000x0000000000000000x000000
00000000000x00000000000000x0000000
000000000000x000000000000x00000000
0000000000000x0000000000x000000000
00000000000000xxxx00xxxx0000000000