00000000000000xxxxxxxxxxxxxxxxxxxx00000000000000
0000000000000x00000000000000000000x0000000000000
000000000000x0000000000000000000000x000000000000
00000000000x000000000000000000000000x00000000000
0000000000x00000000000000000000000000x0000000000
000000000x0000000000000000000000000000x000000000
00000000x000000000000000000000000000000x00000000
0000000x00000000000000000000000000000000x0000000
000000x0000000000000000000000000000000000x000000
00000x00000000000g0g0g0g0g0g0g0g0000000000x00000
0000x00000000000000000000000000000000000000x0000
000x00000e0000000000000000000000000000e00000x000
00x000000000000000000000000000000000000000000x00
0x0000000e0000000000000000000000000000e0000000x0
0x00000000000000000000000000000000000000000000x0
0x0000000e0000000000000000000000000000e0000000x0
00x000000000000000000000000000000000000000000x00
000x00000e0000000000000000000000000000e00000x000
0000x00000000000000000000000000000000000000x0000
00000x00000000000g0g0g0g0g0g0g0g0000000000x00000
000000x0000000000000000000000000000000000x000000
0000000x00000000000000000000000000000000x0000000
00000000x000000000000000000000000000000x00000000
000000000x0000000000000000000000000000x000000000
0000000000x00000000000000000000000000x0000000000
00000000000x000000000000000000000000x00000000000
000000000000x0000000000000000000000x000000000000
0000000000000x00000000000000000000x0000000000000
00000000000000xxxxxxxxxxxxxxxxxxxx00000000000000